a.m.	《時間を表す数字の後につける》『午前』（ラテン語ａｎｔｅ　ｍｅｒｉｄｉｅｍの略）
abacus	そろばん
abalone	〈Ｃ〉アワビ；〈Ｕ〉アワビの身
abase	〈品位・地位など〉‘を’落とす，下げる；〈自分〉‘を’卑しめる
abash	《通例受動態で用いて》…‘を’恥じ入らせる；…‘を’まごつかせる，面くらわせる
abduction	誘かい
aberrant	正道からはずれた，常軌を逸した；異常な
abeyance	一時的な中止（停止）
abhorrence	大きらいなもの；〈Ｕ〉（…を）大きらいなこと《＋『ｏｆ』＋『名』（ｄｏｉｎｇ）》
ably	りっぱに，うまく
abnegate	〈権利など〉‘を’放棄する
abode	〈Ｃ〉住所，住居	〈Ｕ〉滞在，居住	ａｂｉｄｅの過去・過去分詞
abominate	《文》…‘を’忌みきらう；《話》…‘が’大きらい
abomination	〈Ｕ〉傑悪，憎悪	〈Ｃ〉傑悪するもの，いまわしいこと
about-face	回れ右；１８０度の方向転換	（方針などの）転換	回れ右をする	方針（思想）などを転換する
abrade	〈皮膚〉‘を’擦傷する；〈毛・岩など〉‘を’すり減らす
abrasively	
abridge	〈本・話など〉‘を’要約する；〈会合・授業など〉‘を’短縮する	〈権利・活動範囲など〉‘を’制限する
abruptly	突然に，不意に
abscond	（…から）〈犯人などが〉ひそかに逃亡する，行くえをくらます《＋『ｆｒｏｍ』＋『名』》
absenteeism	（仕事・学校などの）常習的欠席，欠勤；長期欠席
absolve	（特に宗教で）（…から）〈人〉‘を’赦免する《＋『名』〈人〉＋『ｏｆ』＋『名』》	（罰金・責任などから）〈人〉‘を’免除する《＋『名』〈人〉＋『ｆｒｏｍ』＋『名』（ｄｏ『ｉｎｇ』）》
abstemious	（飲食物・享楽を）慎む，節制する；（食事が）節約した
abstention	（…を）節制すること，控えること《＋『ｆｒｏｍ』＋『名』（ｄｏ『ｉｎｇ』）》	（投票の）棄権
abstruse	（教義・論理など）難解な，深遠な
abut	（…に）接する，隣接する《＋『ｏｎ』（『ｕｐｏｎ』，『ｏｎｔｏ』）＋『名』》	（他の建物に）よりかかる《＋『ａｇａｉｎｓｔ』＋『名』》
abysmal	底知らずの	《話》とても悪い
acclimate	《米》〈人・生物〉‘を’新しい環境（風土）に慣れさせる《＋『名』＋『ｔｏ』＋『名』（ｄｏ『ｉｎｇ』）》
acclimatization	＝ａｃｃｌｉｍａｔｉｏｎ
accost	〈見知らぬ人〉‘に’近寄って話しかける
accountancy	会計係（計理士）の職務（業務）
accreditation	
acerbity	〈Ｕ〉渋味，にがさ	〈Ｕ〉〈Ｃ〉辛らつさ
acidic	
acidulous	（味が）多少すっぱい	（言動が）しんらつな
acknowledged	
acknowledgement	
acme	《ｔｈｅ　～》（…の）絶頂，極致（ｐｅａｋ）《＋『ｏｆ』＋『名』》
acne	にきび（ｐｉｍｐｌｅ）
acquiesce	（…に）いやいやながら従う，黙従する《＋『ｉｎ』＋『名』》
acrimonious	（言葉・態度・気質が）厳しい，しんらつな
acrimony	（言葉・態度・気質などの）厳しさ，しんらつさ
acrophobia	高所恐怖症
activation	活動化	（物質の）活性化（化学反応を起こしやすくすること）
activism	（政治・社会的目標を達成するための）実践主義
actuate	〈機械など〉‘を’動かす	《通例受動態で》〈動機などが〉〈人〉‘を’行動させる，動かす
acuity	（知覚の）鋭さ，鋭敏
ad	《話》広告（ａｄｖｅｒｔｉｓｅｍｅｎｔの略）
adamantly	
adaptive	適応できる，適応性のある
